label;study;year;country;center;matching;stars;robins;post2018;eq_baseline;start;end;evexp;nonevexp;nexp;evctrl;nonevctrl;nctrl
1653;Audige et al. 2022;2022;France;Multicenter studies;Studies without patient matching;7;Studies with ROBINS-I: Moderate;Studies published after 2018;0;1/1/2007;31/12/2019;2;199;201;12;192;204
1014;Banapour et al. 2018;2018;USA;Multicenter studies;Studies with patient matching;6;Studies with ROBINS-I: Moderate;Studies published after 2018;0;1/1/2007;31/12/2014;8;155;163;9;167;176
1410;Bianchi et al. 2020;2020;Italy;Single-center studies;Studies without patient matching;7;Studies with ROBINS-I: Moderate;Studies published after 2018;0;1/1/2006;31/12/2017;3;80;83;28;215;243
1017;Boylu et al. 2015;2015;Turkey;Single-center studies;Studies without patient matching;7;Studies with ROBINS-I: Moderate;Studies published before 2018;0;1/1/2009;31/12/2013;1;45;46;0;20;20
1727;Bravi et al. 2023;2023;Italy;Multicenter studies;Studies with patient matching;8;Studies with ROBINS-I: Low;Studies published after 2018;0;1/1/2004;31/12/2018;103;2301;2404;55;1008;1063
1026;Chang et al. 2018;2018;Korea;Multicenter studies;Studies with patient matching;8;Studies with ROBINS-I: Low;Studies published after 2018;1;1/1/2006;31/12/2012;3;119;122;2;120;122
1875;Deka et al. 2024;2024;India;Single-center studies;Studies without patient matching;6;Studies with ROBINS-I: Serious;Studies published after 2018;1;1/1/2012;31/12/2020;6;101;107;3;50;53
1536;Ficarra et al. 2014;2014;Italy;Multicenter studies;Studies with patient matching;8;Studies with ROBINS-I: Low;Studies published before 2018;1;1/1/2009;31/1/2011;9;149;158;9;154;163
1726;Gandi et al. 2022;2022;Italy;Single-center studies;Studies with patient matching;8;Studies with ROBINS-I: Low;Studies published after 2018;0;1/1/2014;31/12/2019;2;69;71;6;65;71
1040;Ghali et al. 2019;2019;USA;Single-center studies;Studies without patient matching;6;Studies with ROBINS-I: Moderate;Studies published after 2018;0;1/7/2008;30/6/2016;2;57;59;1;90;91
1400;Ghavimi et al. 2021;2021;Canada;Multicenter studies;Studies without patient matching;7;Studies with ROBINS-I: Moderate;Studies published after 2018;0;1/1/2011;31/10/2018;32;252;284;45;701;746
1748;Hoeh et al. 2023;2023;Germany;Single-center studies;Studies with patient matching;7;Studies with ROBINS-I: Moderate;Studies published after 2018;0;1/1/2003;31/1/2021;6;117;123;11;457;468
1648;Jelley et al. 2017;2017;UK;Single-center studies;Studies without patient matching;6;Studies with ROBINS-I: Moderate;Studies published before 2018;1;1/1/2010;31/12/2015;2;53;55;2;70;72
1657;Kim et al. 2012;2012;Korea;Single-center studies;Studies without patient matching;5;Studies with ROBINS-I: Serious;Studies published before 2018;0;1/4/2009;30/6/2011;2;65;67;1;82;83
1066;Klaassen et al. 2014;2014;USA;Single-center studies;Studies without patient matching;6;Studies with ROBINS-I: Serious;Studies published before 2018;0;1/8/2006;28/2/2012;2;33;35;0;23;23
1067;Kowalewski et al. 2021;2021;Germany;Single-center studies;Studies with patient matching;8;Studies with ROBINS-I: Moderate;Studies published after 2018;1;1/1/2010;31/12/2018;3;70;73;2;137;139
1735;Kowalewski et al. 2023;2023;Germany;Single-center studies;Studies with patient matching;9;Studies with ROBINS-I: Low;Studies published after 2018;1;1/1/2020;1/1/2022;1;24;25;0;25;25
1778;Kumar et al. 2024;2024;India;Single-center studies;Studies without patient matching;6;Studies with ROBINS-I: Serious;Studies published after 2018;0;1/6/2015;28/2/2022;0;25;25;2;11;13
1534;Lee et al. 2011;2011;Korea;Single-center studies;Studies without patient matching;6;Studies with ROBINS-I: Serious;Studies published before 2018;0;1/5/2003;31/12/2010;0;69;69;6;228;234
1656;Lee et al. 2016;2016;Korea;Single-center studies;Studies with patient matching;7;Studies with ROBINS-I: Low;Studies published before 2018;0;1/1/2007;31/12/2013;0;84;84;2;82;84
1877;Love et al. 2024;2024;USA;Single-center studies;Studies without patient matching;6;Studies with ROBINS-I: Moderate;Studies published after 2018;0;1/1/2000;31/12/2022;28;821;849;39;346;385
1077;Lucas et al. 2012;2012;USA;Single-center studies;Studies with patient matching;7;Studies with ROBINS-I: Moderate;Studies published before 2018;1;1/1/2004;31/12/2010;1;16;17;5;39;44
1079;Luciani et al. 2017;2017;Italy;Single-center studies;Studies with patient matching;6;Studies with ROBINS-I: Serious;Studies published before 2018;0;1/1/2005;30/6/2016;7;103;110;0;73;73
1081;Malkoc et al. 2017;2017;USA;Single-center studies;Studies without patient matching;7;Studies with ROBINS-I: Serious;Studies published before 2018;0;1/1/2009;30/11/2015;3;51;54;2;54;56
1779;Masoumi-Ravandi et al. 2024;2024;Canada;Single-center studies;Studies without patient matching;6;Studies with ROBINS-I: Serious;Studies published after 2018;0;1/2/2015;31/7/2021;6;76;82;2;104;106
1542;Masson-Lecomte et al. 2013;2013;France;Single-center studies;Studies without patient matching;7;Studies with ROBINS-I: Moderate;Studies published before 2018;0;1/1/2008;31/12/2010;1;41;42;4;54;58
1537;Maurice et al. 2017;2017;USA;Single-center studies;Studies without patient matching;6;Studies with ROBINS-I: Serious;Studies published before 2018;0;1/1/2011;31/12/2015;19;387;406;8;178;186
1083;Mearini et al. 2016;2016;Italy;Single-center studies;Studies without patient matching;6;Studies with ROBINS-I: Serious;Studies published before 2018;0;1/1/2006;31/12/2015;2;29;31;9;71;80
1084;Mehra et al. 2019;2019;India;Single-center studies;Studies with patient matching;6;Studies with ROBINS-I: Moderate;Studies published after 2018;1;1/1/2011;31/7/2018;1;10;11;1;19;20
1091;Motoyama et al. 2019;2019;Japan;Single-center studies;Studies with patient matching;7;Studies with ROBINS-I: Low;Studies published after 2018;0;1/7/2010;31/8/2017;0;37;37;3;34;37
1098;Oh et al. 2014;2014;Korea;Single-center studies;Studies with patient matching;8;Studies with ROBINS-I: Low;Studies published before 2018;1;1/5/2003;31/5/2013;0;100;100;1;99;100
1100;Oh et al. 2016;2016;Korea;Single-center studies;Studies with patient matching;7;Studies with ROBINS-I: Serious;Studies published before 2018;1;1/5/2003;31/7/2015;4;295;299;5;294;299
1113;Porpiglia et al. 2016;2016;Italy;Multicenter studies;Studies without patient matching;9;Studies with ROBINS-I: Low;Studies published before 2018;0;1/1/2009;31/12/2013;2;78;80;9;123;132
1878;Roaldsen et al. 2024;2024;Norway;Multicenter studies;Studies without patient matching;7;Studies with ROBINS-I: Moderate;Studies published after 2018;1;1/1/2010;31/12/2020;5;117;122;16;59;75
1055;Sawada et al. 2021;2021;Japan;Single-center studies;Studies with patient matching;7;Studies with ROBINS-I: Low;Studies published after 2018;1;1/1/2005;31/12/2020;1;51;52;0;55;55
1131;Soisrithong et al. 2021;2021;Thailand;Single-center studies;Studies without patient matching;7;Studies with ROBINS-I: Serious;Studies published after 2018;1;1/1/2009;31/12/2018;2;39;41;0;18;18
1135;Tan et al. 2018;2018;Australia;Single-center studies;Studies without patient matching;8;Studies with ROBINS-I: Moderate;Studies published after 2018;0;1/1/2010;31/12/2016;5;140;145;6;49;55
1142;Vittori et al. 2014;2014;Italy;Multicenter studies;Studies without patient matching;9;Studies with ROBINS-I: Low;Studies published before 2018;0;1/1/2010;31/12/2011;6;99;105;11;187;198
1663;Yu et al. 2019;2019;Korea;Single-center studies;Studies with patient matching;7;Studies with ROBINS-I: Moderate;Studies published after 2018;1;1/2/2004;30/4/2017;1;302;303;7;296;303
1524;Zeuschner et al. 2021;2021;Germany;Single-center studies;Studies with patient matching;6;Studies with ROBINS-I: Moderate;Studies published after 2018;0;1/1/2007;31/12/2018;32;468;500;22;291;313
